
IIIIIIIIIIIIIIIIII
I                I
I        r       I
I      III       I
I J    IDI    r  I
ImmmmmmIDImmmIIIII
ImbmmmmIDImmmIDDDI
ImmmmmmIDImmmIDDDI
IIIIIIIIDIsIIIDDDI
IDDDDDDDDDDDDDDDDI
IDDDDDDDDDDDDDDDDI
IIIIIIIIIIIIIIIIII
